11 11 11 11 11 11 11 11 11 11 11 11 11 11 11 11 11 11 11 11 11 11 11 11 11 11 11 11 11 11 11 11 11 11 11 11 11 11 11 11 11 11 11 11 11 11 11 11 11 11 11 11 11 11 11 11 11 11 11 11 11 11 11 11 11
11 11 11 11 11 11 11 11 11 11 11 11 11 11 11 11 11 11 11 11 11 11 11 11 11 11 11 11 11 11 11 11 11 11 11 11 11 11 11 11 11 11 11 11 11 11 11 11 11 11 11 11 11 11 11 11 11 11 11 11 11 11 11 11 11
11 11 11 11 11 11 11 11 11 11 11 11 11 11 11 11 11 11 11 11 11 11 11 11 11 11 11 11 11 11 11 11 11 11 11 11 11 11 11 11 11 11 11 11 11 11 11 11 11 11 11 11 11 11 11 11 11 11 11 11 11 11 11 11 11
11 11 11 11 11 11 11 11 11 11 1 1 11 11 14 0 0 0 14 11 12 12 12 12 12 12 12 12 12 12 12 12 12 12 12 12 12 12 12 12 12 12 12 12 12 12 12 12 12 12 12 12 12 12 12 11 11 11 11 11 11 11 11 11 11
11 11 11 11 11 11 11 11 14 11 1 1 1 1 1 1 1 1 1 1 1 1 1 1 1 1 1 1 1 1 1 1 1 1 1 1 1 1 1 1 1 1 1 1 1 1 1 1 1 1 1 0 0 0 12 11 11 11 11 11 11 11 11 11 12 11 11 11 11 11 11 11 11 11 11
11 11 11 11 11 11 11 1 1 1 1 1 1 1 1 1 1 1 1 1 1 1 1 1 1 1 1 1 1 1 1 1 1 1 1 1 1 1 1 1 1 1 1 1 1 1 1 1 1 1 1 1 11 11 12 11 11 11 11 11 11 11 11 11 12 11 11 11 11 11 11 11 11 11 11
11 11 11 11 11 11 11 1 2 3 3 3 3 3 4 11 14 1 1 12 12 0 1 1 1 1 11 0 0 11 11 11 11 11 11 1 1 1 1 1 1 1 1 14 0 14 0 14 0 14 11 11 11 11 12 11 11 11 11 11 11 11 11 11 11
11 11 11 11 11 11 14 1 7 9 9 9 9 9 8 11 11 1 1 11 12 14 1 1 14 11 0 0 11 2 3 3 4 11 11 14 11 11 11 11 11 1 1 1 2 3 4 11 11 11 11 11 11 11 12 11 11 11 11 11 11 11 11 11 11
11 11 11 11 11 11 1 1 7 9 9 9 9 9 8 11 11 1 1 11 12 11 1 1 11 11 11 11 11 7 9 9 8 11 11 11 11 11 11 11 11 1 1 1 5 10 6 11 11 11 11 11 11 11 12 11 11 11 11 11 11 11 11 11 11
11 11 11 11 11 11 1 11 7 9 9 9 9 9 8 11 11 1 1 11 12 11 1 1 11 11 11 11 11 5 10 10 6 11 11 11 11 11 12 12 12 12 12 12 12 12 12 12 12 12 12 12 12 11 12 11 11 11 11 11 11 11 11 11 11
11 11 11 11 11 11 1 14 7 9 9 9 9 9 8 11 11 1 1 11 12 11 1 1 1 1 1 14 11 14 11 11 14 11 11 14 11 11 12 13 13 13 13 12 13 13 13 12 13 13 12 13 12 11 12 11 11 11 11 11 11 11 11 11 11
11 11 11 11 11 11 1 11 5 10 10 9 9 9 6 11 14 1 1 11 12 14 11 11 14 1 1 1 1 1 1 1 1 1 1 1 1 14 12 13 13 13 13 13 13 13 13 13 13 13 13 13 12 11 12 11 11 11 11 11 11 11 11 11 11 11 11 11 11 11 11 11 11 11 11
11 11 11 11 11 11 1 14 11 11 11 7 9 8 11 11 11 1 1 11 12 11 11 11 11 14 11 11 14 11 14 11 11 11 11 11 11 11 12 13 13 13 13 13 13 13 13 13 13 13 13 13 12 11 12 11 11 11 11 11 11 11 11 11 11
11 11 11 11 11 11 1 11 11 11 11 7 9 8 11 11 14 1 1 11 12 12 12 12 12 12 12 12 12 12 12 12 12 12 12 12 12 12 12 13 13 13 13 12 13 13 13 12 13 12 13 13 12 11 12 11 11 11 11 11 11 11 11 11 11
11 11 11 11 11 11 1 0 11 11 11 7 9 8 11 11 11 1 1 11 11 11 11 11 11 11 11 11 11 11 11 11 11 11 11 11 11 11 11 12 12 12 12 12 12 12 12 12 12 12 12 12 12 12 12 11 11 11 11 11 11 11 11 11 11
11 11 11 11 11 11 1 0 0 12 12 12 12 12 12 12 12 13 13 12 11 11 11 11 11 11 11 11 11 11 11 11 11 11 11 11 11 11 11 11 11 11 11 11 11 11 11 11 11 11 11 11 11 11 11 11 11 11 11 11 11 11 11 11 11
11 11 11 11 11 11 1 1 1 13 13 13 13 13 13 13 13 13 13 12 11 11 11 11 11 11 11 11 11 14 11 14 11 14 11 14 11 14 11 11 14 11 11 11 11 11 11 11 11 11 11 11 11 11 11 11 11 11 11 11 11 11 11 11 11
11 11 11 11 11 11 1 1 1 13 13 13 13 13 13 13 13 13 13 12 14 11 11 11 11 11 11 11 1 1 1 1 1 1 1 1 1 1 1 1 1 1 11 11 11 11 11 11 11 11 11 11 11 11 11 11 11 11 11 11 11 11 11 11 11
11 11 11 11 11 11 1 0 0 12 12 12 12 12 12 12 12 13 13 13 1 1 1 1 1 1 1 1 1 1 2 3 3 3 3 3 3 3 3 4 1 1 1 0 14 0 14 0 14 0 11 11 11 11 11 11 11 11 11 11 11 11 11 11 11
11 11 11 11 11 11 1 0 11 11 11 7 9 8 0 0 12 13 13 13 0 11 14 0 11 0 0 11 14 0 7 9 9 9 9 9 9 9 9 8 1 1 1 1 1 1 1 1 1 11 11 11 11 11 11 11 11 11 11 11 11 11 11 11 11
11 11 11 11 11 11 1 11 11 11 11 7 9 9 3 3 12 13 13 12 3 3 3 3 3 3 3 3 3 3 9 9 9 9 9 9 9 9 9 8 1 1 11 11 0 0 14 0 11 11 11 11 11 11 11 11 11 11 11 11 11 11 11 11 11
11 11 11 11 11 11 1 14 11 11 11 7 9 9 9 9 12 13 13 12 9 9 9 9 9 9 9 9 9 9 9 9 9 9 9 9 9 9 9 8 12 13 12 11 11 11 11 11 11 11 11 11 11 11 11 11 11 11 11 11 11 11 11 11 11
11 11 11 11 11 11 1 11 11 11 11 7 9 9 10 10 12 13 13 12 10 10 10 10 10 10 10 10 10 10 9 9 9 9 9 9 9 9 9 9 12 13 12 3 3 3 3 3 3 4 11 11 11 11 11 11 11 11 11 11 11 11 11 11 11
11 11 11 11 11 11 1 0 0 11 11 7 9 8 0 0 12 13 13 12 0 0 11 11 11 11 11 11 0 0 7 9 9 9 9 9 9 9 9 9 12 13 12 10 10 10 10 10 9 8 11 11 11 11 11 11 11 11 11 11 11 11 11 11 11
11 11 11 11 11 11 1 14 11 11 11 7 9 8 0 0 12 13 13 12 0 0 0 0 11 11 11 11 0 0 7 9 9 9 9 9 9 9 9 8 12 13 12 11 11 11 11 11 7 8 11 11 11 11 11 11 11 11 11 11 11 11 11 11 11
11 11 11 11 11 11 1 11 11 11 11 7 9 8 0 12 12 13 13 1 1 1 1 1 1 1 1 11 11 0 5 10 10 10 10 10 10 10 10 6 1 1 1 14 11 11 11 11 7 8 11 11 11 11 11 11 11 11 11 11 11 11 11 11 11
11 11 11 11 11 11 1 0 0 12 12 12 12 12 12 12 13 13 13 12 0 0 0 0 0 1 1 1 1 1 1 1 1 1 1 1 1 1 1 1 1 1 1 1 1 11 11 11 7 8 11 11 11 11 11 11 11 11 11 11 11 11 11 11 11
11 11 11 11 11 11 1 1 1 13 13 13 13 13 13 13 13 13 13 12 0 0 0 11 11 11 11 11 11 11 11 11 11 11 11 11 11 11 11 11 11 11 1 1 0 11 11 11 7 8 11 11 11 11 11 11 11 11 11 11 11 11 11 11 11
11 11 11 11 11 11 1 1 1 13 13 13 13 13 13 13 13 13 13 12 11 11 11 11 11 11 11 11 11 11 11 11 11 11 11 11 11 11 11 11 11 11 1 1 0 11 11 11 7 8 11 11 11 11 11 11 11 11 11 11 11 11 11 11 11
11 11 11 11 11 11 1 0 0 12 12 12 12 12 12 12 13 13 13 12 11 11 11 11 11 11 11 11 11 11 11 11 11 11 11 11 11 11 11 11 11 11 1 1 0 11 11 11 7 8 11 11 11 11 11 11 11 11 11 11 11 11 11 11 11
11 11 11 11 11 11 1 0 0 11 11 7 9 8 0 12 13 13 13 12 11 11 11 2 3 3 3 3 3 3 3 3 3 3 3 3 3 3 3 4 0 0 1 1 0 11 11 11 7 8 11 11 11 11 11 11 11 11 11 11 11 11 11 11 11
11 11 11 11 11 11 1 11 11 11 11 7 9 8 0 12 13 13 13 13 12 11 11 7 9 9 9 9 9 9 9 9 9 9 9 9 9 9 9 8 0 0 1 1 1 14 11 11 7 8 11 11 11 11 11 11 11 11 11 11 11 11 11 11 11
11 11 11 11 11 11 11 11 11 11 11 7 9 8 0 12 13 13 13 13 12 0 0 7 9 9 9 9 9 9 9 9 9 9 9 9 9 9 9 8 14 1 1 1 0 11 11 11 7 8 11 11 11 11 11 11 11 11 11 11 11 11 11 11 11
11 11 11 11 11 11 11 11 11 11 11 7 9 8 0 12 13 13 13 13 12 0 0 7 9 9 9 9 9 9 9 9 9 9 9 9 9 9 9 8 11 11 1 1 0 11 11 11 7 8 11 11 11 11 11 11 11 11 11 11 11 11 11 11 11
11 11 11 11 11 11 11 11 11 11 11 7 9 9 3 12 13 13 13 13 12 3 3 9 9 9 9 9 9 9 9 9 9 9 9 9 9 9 9 8 11 11 1 1 0 11 11 11 7 8 11 11 11 11 11 11 11 11 11 11 11 11 11 11 11
11 11 11 11 11 11 11 11 11 11 11 7 9 9 9 12 13 13 13 13 12 9 9 9 9 9 9 9 9 9 9 9 9 9 9 9 9 9 9 8 11 11 1 1 0 11 11 11 7 8 11 11 11 11 11 11 11 11 11 11 11 11 11 11 11
11 11 11 11 11 11 11 11 11 11 11 5 9 9 10 12 13 13 13 13 12 10 10 9 9 9 9 9 9 9 9 9 9 9 9 9 9 9 9 8 14 1 1 1 0 11 11 11 7 8 11 11 11 11 11 11 11 11 11 11 11 11 11 11 11
11 11 11 11 11 11 11 11 11 11 11 11 7 8 0 12 13 13 13 13 12 0 0 7 9 9 9 9 9 9 9 9 9 9 9 9 9 9 9 8 11 11 1 1 1 1 14 11 7 8 11 11 11 11 11 11 11 11 11 11 11 11 11 11 11
11 11 11 11 11 11 11 11 11 11 11 11 7 8 0 12 13 13 13 13 12 0 0 7 9 9 9 9 9 9 9 9 9 9 9 9 9 9 9 8 11 11 0 1 1 11 11 11 7 8 11 11 11 11 11 11 11 11 11 11 11 11 11 11 11
11 11 11 11 11 11 11 11 11 11 11 11 7 8 0 0 1 1 1 1 0 0 0 7 9 9 9 9 9 9 9 9 9 9 9 9 9 9 9 8 11 11 11 1 1 14 0 0 7 8 11 11 11 11 11 11 11 11 11 11 11 11 11 11 11
11 11 11 11 11 11 11 11 11 11 11 11 7 8 11 0 0 1 1 0 0 0 0 7 9 9 9 9 9 9 9 9 9 9 9 9 9 9 9 8 11 11 14 1 1 0 0 0 7 8 11 11 11 11 11 11 11 11 11 11 11 11 11 11 11 11
11 11 11 11 11 11 11 11 11 11 11 11 7 8 11 11 14 1 1 14 0 0 0 5 10 10 10 10 10 10 10 10 10 10 10 10 10 10 10 6 0 0 0 1 1 14 11 11 7 8 11 11 11 11 11 11 11 11 11 11 11 11 11 11 11
11 11 11 11 11 11 11 11 11 11 11 11 7 8 11 11 11 1 1 11 11 11 11 11 11 11 11 11 11 11 11 11 11 11 11 11 11 11 11 11 11 11 14 1 1 11 11 11 7 8 11 11 11 11 11 11 11 11 11 11 11 11 11 11 11
11 11 11 11 11 11 11 11 11 11 11 11 7 8 11 11 14 1 1 14 11 11 11 11 11 11 11 11 11 11 11 11 11 11 11 11 11 11 11 11 11 11 11 1 1 14 2 3 9 9 3 4 11 11 11 11 11 11 11 11 11 11 11 11 11
11 11 11 11 11 11 11 11 11 11 11 11 7 8 11 11 11 1 1 0 14 11 11 11 11 11 11 11 11 11 11 11 11 11 11 11 11 11 11 11 11 11 11 1 1 0 7 9 9 9 9 8 11 11 11 11 11 11 11 11 11 11 11 11 11
11 11 11 11 11 11 11 11 11 11 11 11 7 8 11 11 14 1 1 1 1 1 1 11 11 11 11 11 0 14 0 0 14 0 0 14 0 0 0 14 0 0 14 1 1 14 7 9 9 9 9 8 11 11 11 11 11 11 11 11 11 11 11 11 11
11 11 11 11 11 11 11 11 11 11 11 11 7 8 11 11 11 1 1 1 1 1 1 1 1 1 1 1 1 1 1 1 1 1 1 1 1 1 1 1 1 1 1 1 1 0 7 9 9 9 9 8 11 11 11 11 11 11 11 11 11 11 11 11 11
11 11 11 11 11 11 11 11 11 11 11 11 7 8 11 11 11 1 1 1 1 1 1 1 1 1 1 1 1 1 1 1 1 1 1 1 1 1 1 1 1 1 1 1 1 11 7 9 9 9 9 8 11 11 11 11 11 11 11 11 11 11 11 11 11
11 11 11 11 11 11 11 11 11 11 11 11 7 8 11 11 11 11 11 11 11 11 11 11 11 11 11 11 0 0 14 0 14 0 14 0 14 0 14 11 11 11 11 11 11 11 7 9 9 9 9 6 11 11 11 11 11 11 11 11 11 11 11 11 11
11 11 11 11 11 11 11 11 11 11 11 11 7 9 3 3 3 3 3 3 3 3 3 3 3 3 3 3 3 3 3 3 3 3 3 3 3 3 3 3 3 3 3 3 3 3 9 9 9 9 8 11 11 11 11 11 11 11 11 11 11 11 11 11 11
11 11 11 11 11 11 11 11 11 11 11 11 5 10 10 10 10 10 10 10 10 10 10 10 10 10 10 10 10 10 10 10 10 10 10 10 10 10 10 10 10 10 10 10 10 10 10 10 10 10 6 11 11 11 11 11 11 11 11 11 11 11 11 11 11
11 11 11 11 11 11 11 11 11 11 11 11 11 11 11 11 11 11 11 11 11 11 11 11 11 11 11 11 11 11 11 11 11 11 11 11 11 11 11 11 11 11 11 11 11 11 11 11 11 11 11 11 11 11 11 11 11 11 11 11 11 11 11 11 11
11 11 11 11 11 11 11 11 11 11 11 11 11 11 11 11 11 11 11 11 11 11 11 11 11 11 11 11 11 11 11 11 11 11 11 11 11 11 11 11 11 11 11 11 11 11 11 11 11 11 11 11 11 11 11 11 11 11 11 11 11 11 11 11 11
11 11 11 11 11 11 11 11 11 11 11 11 11 11 11 11 11 11 11 11 11 11 11 11 11 11 11 11 11 11 11 11 11 11 11 11 11 11 11 11 11 11 11 11 11 11 11 11 11 11 11 11 11 11 11 11 11 11 11 11 11 11 11 11 11
11 11 11 11 11 11 11 11 11 11 11 11 11 11 11 11 11 11 11 11 11 11 11 11 11 11 11 11 11 11 11 11 11 11 11 11 11 11 11 11 11 11 11 11 11 11 11 11 11 11 11 11 11 11 11 11 11 11 11 11 11 11 11 11 11
11 11 11 11 11 11 11 11 11 11 11 11 11 11 11 11 11 11 11 11 11 11 11 11 11 11 11 11 11 11 11 11 11 11 11 11 11 11 11 11 11 11 11 11 11 11 11 11 11 11 11 11 11 11 11 11 11 11 11 11 11 11 11 11 11
11 11 11 11 11 11 11 11 11 11 11 11 11 11 11 11 11 11 11 11 11 11 11 11 11 11 11 11 11 11 11 11 11 11 11 11 11 11 11 11 11 11 11 11 11 11 11 11 11 11 11 11 11 11 11 11 11 11 11 11 11 11 11 11 11
11 11 11 11 11 11 11 11 11 11 11 11 11 11 11 11 11 11 11 11 11 11 11 11 11 11 11 11 11 11 11 11 11 11 11 11 11 11 11 11 11 11 11 11 11 11 11 11 11 11 11 11 11 11 11 11 11 11 11 11 11 11 11 11 11
11 11 11 11 11 11 11 11 11 11 11 11 11 11 11 11 11 11 11 11 11 11 11 11 11 11 11 11 11 11 11 11 11 11 11 11 11 11 11 11 11 11 11 11 11 11 11 11 11 11 11 11 11 11 11 11 11 11 11 11 11 11 11 11 11
11 11 11 11 11 11 11 11 11 11 11 11 11 11 11 11 11 11 11 11 11 11 11 11 11 11 11 11 11 11 11 11 11 11 11 11 11 11 11 11 11 11 11 11 11 11 11 11 11 11 11 11 11 11 11 11 11 11 11 11 11 11 11 11 11
11 11 11 11 11 11 11 11 11 11 11 11 11 11 11 11 11 11 11 11 11 11 11 11 11 11 11 11 11 11 11 11 11 11 11 11 11 11 11 11 11 11 11 11 11 11 11 11 11 11 11 11 11 11 11 11 11 11 11 11 11 11 11 11 11
11 11 11 11 11 11 11 11 11 11 11 11 11 11 11 11 11 11 11 11 11 11 11 11 11 11 11 11 11 11 11 11 11 11 11 11 11 11 11 11 11 11 11 11 11 11 11 11 11 11 11 11 11 11 11 11 11 11 11 11 11 11 11 11 11
11 11 11 11 11 11 11 11 11 11 11 11 11 11 11 11 11 11 11 11 11 11 11 11 11 11 11 11 11 11 11 11 11 11 11 11 11 11 11 11 11 11 11 11 11 11 11 11 11 11 11 11 11 11 11 11 11 11 11 11 11 11 11 11 11
11 11 11 11 11 11 11 11 11 11 11 11 11 11 11 11 11 11 11 11 11 11 11 11 11 11 11 11 11 11 11 11 11 11 11 11 11 11 11 11 11 11 11 11 11 11 11 11 11 11 11 11 11 11 11 11 11 11 11 11 11 11 11 11 11
11 11 11 11 11 11 11 11 11 11 11 11 11 11 11 11 11 11 11 11 11 11 11 11 11 11 11 11 11 11 11 11 11 11 11 11 11 11 11 11 11 11 11 11 11 11 11 11 11 11 11 11 11 11 11 11 11 11 11 11 11 11 11 11 11